Adiós	Masculine	aðjˈos	Goodbye
Adorable		ˌaðoɾˈaβle	Adorable
Alumbración	Feminine	ˌalumbɾaθjˈon	Enlightenment
Amistad	Feminine	ˌamistˈad	Friendship
Amor	Masculine	amˈoɾ	Love
Bondad	Feminine	bondˈad	Kindness
Belleza	Feminine	beʎˈeθa	Beauty
Caleidoscopio	Masculine	kˌale͡ɪðoskˈopjo	Kaleidoscope
Camino	Masculine	kamˈino	Path
Compasión	Feminine	kˌompasjˈon	Compassion
Coraje	Masculine	koɾˈaxe	Courage or anger
Cuidar		kwiðˈaɾ	Caring
Complicidad	Feminine	kˌompliθiðˈad	Complicity
Desenlace	Masculine	dˌesenlˈaθe	Outcome
Efímero		efˈimeɾo	Ephemeral
Equilibrio	Masculine	ˌekilˈiβɾio	Balance
Encanto	Masculine	enkˈanto	Charm
Enternecer		ˌenteɾneθˈeɾ	Soften
Epifanía	Feminine	ˌepifanˈia	Epiphany
Esperanza	Feminine	ˌespeɾˈanθa	Hope
Etéreo		etˈeɾeo	Ethereal
Felicidad	Feminine	fˌeliθiðˈad	Happiness
Gentileza	Feminine	xˌentilˈeθa	Gentleness
Honestidad	Feminine	ˌonestiðˈad	Honesty
Honor	Masculine	onˈoɾ	Honor
Imprescindible		ˌimpɾesθindˈiβle	Indispensable
Inexorable		ˌineksoɾˈaβle	Inexorable
Infinito	Masculine	ˌimfinˈito	Infinite
Libertad	Feminine	lˌiβeɾtˈad	Freedom
Madre	Feminine	mˈaðɾe	Mother
Melancolia	Feminine	mˌelankˈolja	Melancholy
Memoria	Feminine	memˈoɾja	Memory
Metáfora	Feminine	metˈafoɾa	Metaphor
Nación	Feminine	naθjˈon	Nation
Nacimiento	Masculine	nˌaθimjˈɛnto	Birth
Palabra	Feminine	palˈaβɾa	Word
Palomitas	Feminine	pˌalomˈitas	Popcorn
Padre	Masculine	pˈaðɾe	Father
Paz	Feminine	pˈaθ	Peace
Perfectamente		peɾfˈektamˈente	Perfectly
Reciprocidad	Feminine	ɾɾˌeθipɾˌoθiðˈad	Reciprocity
Reanudar		ɾɾˌeanuðˈaɾ	Resume
Renacer		ɾɾˌenaθˈeɾ	Reborn
Resiliencia	Feminine	ɾɾˌesiljˈɛnθja	Resilience
Respeto		ɾɾespˈeto	Respect
Risas	Feminine	ɾɾˈisas	Laughter
Sentir	
sentˈiɾ	Feeling
Silencio	Masculine	silˈɛnθjo	Silence
Singularidades	Feminine	sˌiŋɡulˌaɾiðˈaðes	Singularities
Soledad	Feminine	sˌoleðˈad	Solitude
Sublime
Ternura	Feminine	teɾnˈuɾa	Tenderness
Tertulia	Feminine	teɾtˈulja	Talking-shop
Vida	Feminine	bˈiða	Life